0 1 2 3 4 4 4 4
5 6 4 7 4 8 9 2
6 10 11 1 12 13 4 13
14 15 12 16 20 17 9 18
13 6 13 19 16 21 21 22
6 13 23 24 25 26 13 27
28 26 4 26 26 28 29 13
28 28 8 4 30 26 31 9